11111111111111111111111111
1E0000000000000C00000C0001
10100101001000001010010001
10101010001001000000010101
1C00C00000000P0000000000C1
11111111111111111111111111